a	a
b	b
d	d
d͡ʒ	dZ
f	f
f͡ʃ	fS
i	i
j	j
kʰ	kh
kʼ	ke
k͡x	kx
l	l
m	m
n	n
pʰ	ph
pʼ	pe
p͡ʃʰ	pSh
p͡ʃʼ	pSe
r	r
s	s
tʰ	th
tʼ	te
t͡lʰ	tlh
t͡lʼ	tle
t͡sʰ	tsh
t͡sʼ	tse
t͡ʃʰ	tSh
t͡ʃʼ	tSe
u	u
w	w
x	x
ŋ	N
ǃ	qq
ǃʰ	qqh
ɔ	O
ɛ	E
ɦ	hv
ɪ	I
ɬ	K
ɲ	J
ʃ	S
ʊ	U
β͡ʒ	BZ
