a	a
b	b
d	d
d͡ʒ	dZ
f	f
f͡ʃ	fS
i	i
j	j
kʰ	k_h
kʼ	k_>
k͡x	kx
l	l
m	m
n	n
pʰ	p_h
pʼ	p_>
p͡ʃʰ	pS_h
p͡ʃʼ	pS_>
r	r
s	s
tʰ	t_h
tʼ	t_>
t͡lʰ	tl_h
t͡lʼ	tl_>
t͡sʰ	ts_h
t͡sʼ	ts_>
t͡ʃʰ	tS_h
t͡ʃʼ	tS_>
u	u
w	w
x	x
ŋ	N
ǃ	!\
ǃʰ	!\_h
ɔ	O
ɛ	E
ɦ	h\
ɪ	I
ɬ	K
ɲ	J
ʃ	S
ʊ	U
β͡ʒ	BZ
