ə	sin
əi	wyn
a	man
ai	katjie
aʊ	Mauser/Gauteng
ɛ	ken
œ	mus
əu	bou
œy	huis
ŋ	sing
ɔ	son
ɔi	potjie
ʃ	chef
ʒ	mirage
æ	ek
ɑː	aan
ɑːi	saai
b	bad
d	dat
iə	seer
øː	seun
f	fluit
ɡ	gholf
ɦ	hy
i	sien
iu	meeu
j	jou
k	kan
l	loop
m	maan
n	naand
uə	room
ɔːi	rooi
p	pos
r	roes
s	sal
t	toe
tʃ	tjek
dʒ	jazz
u	boek
ui	boei
v	wens
w	twee
x	gee
y	muur
z	zebra
