ə	q
əi	qi
a	a
ai	ai
aʊ	aU
ɛ	E
œ	qoeq
əu	qu
œy	qoeqy
ŋ	N
ɔ	O
ɔi	Oi
ʃ	S
ʒ	Z
æ	qaeq
ɑː	AA
ɑːi	AAi
b	b
d	d
iə	iq
øː	qooq
f	f
ɡ	g
ɦ	hv
i	i
iu	iu
j	j
k	k
l	l
m	m
n	n
uə	uq
ɔːi	OOi
p	p
r	r
s	s
t	t
tʃ	tS
dʒ	dZ
u	u
ui	ui
v	v
w	w
x	x
y	y
z	z
