a	a
b	b
d	d
d͡z	dz
d͡ʒ	dZ
f	f
h	h
i	i
j	j
k	k
kʰ	kh
k͡ɬʼ	kKe
l	l
m	m
n	n
pʰ	ph
pʼ	pe
r	r
s	s
tʰ	th
tʼ	te
t͡sʼ	tse
t͡ʃʼ	tSe
u	u
v	v
w	w
z	z
ŋ	N
ǀ	cc
ǀʰ	cch
ǁ	xx
ǁʰ	xxh
ǃ	qq
ǃʰ	qqh
ɓ	bE
ɔ	O
ɛ	E
ɡ	g
ɡ͡ǀ	gcc
ɡ͡ǁ	gxx
ɡ͡ǃ	gqq
ɦ	hv
ɬ	K
ɮ	lZ
ɲ	J
ʃ	S
