a	a
b	b
d	d
d͡z	dz
d͡ʒ	d_0Z
f	f
h	h
i	i
j	j
k	k
kʰ	k_h
k͡ɬʼ	kK_>
l	l
m	m
n	n
pʰ	p_h
pʼ	p_>
r	r
s	s
tʰ	t_h
tʼ	t_>
t͡sʼ	ts_>
t͡ʃʼ	tS_>
u	u
v	v
w	w
z	z
ŋ	N
ǀ	|\
ǀʰ	|\h
ǁ	|\|\
ǁʰ	|\|\h
ǃ	!\
ǃʰ	!\h
ɓ	b_<
ɔ	O
ɛ	E
ɡ	g
ɡ͡ǀ	|\g_0
ɡ͡ǁ	|\|\g_0
ɡ͡ǃ	!\g_0
ɦ	h\
ɬ	K
ɮ	K\
ɲ	J
ʃ	S
