a	a
b	b
d	d
d͡ʒ	dZ
ɛ	E
f	f
h	h
ɪ	I
i	i
ɲ	J
j	j
kʼ	k_>
kʰ	k_h
k͡x	kx
l	l
m	m
ŋ	N
n	n
ɔ	O
pʼ	p_>
pʰ	p_h
r	r
ʃ	S
s	s
t͡lʼ	tl_>
t͡lʰ	tl_h
t͡sʼ	ts_>
t͡sʰ	ts_h
tʼ	t_>
tʰ	t_h
t͡ʃʼ	tS_>
t͡ʃʰ	tS_h
ʊ	U
u	u
w	w
x	x
