a	a
b	b
d	d
d͡ʒ	dZ
ɛ	E
f	f
h	h
ɪ	I
i	i
ɲ	J
j	j
kʼ	ke
kʰ	kh
k͡x	kx
l	l
m	m
ŋ	N
n	n
ɔ	O
pʼ	pe
pʰ	ph
r	r
ʃ	S
s	s
t͡lʼ	tle
t͡lʰ	tlh
t͡sʼ	tse
t͡sʰ	tsh
tʼ	te
tʰ	th
t͡ʃʼ	tSe
t͡ʃʰ	tSh
ʊ	U
u	u
w	w
x	x
