a	{
aɪ	ai
aʊ	au
b	b
d	d
dʒ	dZ
eɪ	@i
f	f
g	g
h	h\
i	i:
j	j
k	k
l	l
m	m
n	n
p	p
s	s
t	t
tʃ	tS
u	u:
v	v
w	w
z	z
ð	D
ŋ	N
ɑ	A:
ɒ	Q
ɔ	O:
ɔɪ	Oi
ə	@
əʊ	@u
ɛ	E
ɛə	e@
ɜ	3:
ɪ	i
ɪə	i@
ɹ	r\
ʃ	S
ʊ	U
ʊə	u@
ʌ	a
ʒ	Z
θ	T
