a	bad
aɪ	buy
aʊ	cow
b	ban
d	den
dʒ	edge
eɪ	bay
f	fine
g	gain
h	hat
i	bead
j	yes
k	can
l	lad
m	mat
n	nap
p	pot
s	son
t	tan
tʃ	chin
u	boot
v	vain
w	when
z	zen
ð	then
ŋ	sing
ɑ	bard
ɒ	pot
ɔ	port
ɔɪ	boy
ə	about
əʊ	go
ɛ	bed
ɛə	bare
ɜ	bird
ɪ	bid
ɪə	beer
ɹ	ray
ʃ	she
ʊ	put
ʊə	poor
ʌ	bud
ʒ	beige
θ	thin
