a	a
aɪ	ai
aʊ	au
b	b
d	d
dʒ	jh
eɪ	ei
f	f
g	g
h	h
i	ii
j	y
k	k
l	l
m	m
n	n
p	p
s	s
t	t
tʃ	ch
u	uu
v	v
w	w
z	z
ð	dh
ŋ	ng
ɑ	aa
ɒ	o
ɔ	oo
ɔɪ	oi
ə	q
əʊ	ou
ɛ	e
ɛə	eq
ɜ	qq
ɪ	i
ɪə	iq
ɹ	r
ʃ	sh
ʊ	u
ʊə	uq
ʌ	uh
ʒ	zh
θ	th
