a	a
bʰ	bh
cʰ	ch
cʼ	ce
d	d
d͡ʒ	dZ
f	f
h	h
i	i
j	j
kʰ	kh
kʼ	ke
k͡xʼ	kxe
l	l
m	m
mʰ	mh
n	n
nʰ	nh
pʰ	ph
pʼ	pe
r	r
s	s
tʰ	th
tʼ	te
t͡sʼ	tse
t͡ɬʼ	tKe
t͡ʃʰ	tSh
t͡ʃʼ	tSe
u	u
v	v
w	w
x	x
z	z
ŋ	N
ǀ	cc
ǀʰ	cch
ǁ	xx
ǁʰ	xxh
ǃ	qq
ǃʰ	qqh
ɓ	bE
ɔ	O
ɛ	E
ɟ	dy
ɡ	g
ɡ͡ǀ	gcc
ɡ͡ǁ	gxx
ɡ͡ǃ	gqq
ɣ	G
ɬ	K
ɮ	lZ
ɲ	J
ɲʰ	Jh
ʃ	S
