a	a
bʰ	b_h
cʰ	c_h
cʼ	c_>
d	d
d͡ʒ	d_0Z
f	f
h	h
i	i
j	j
kʰ	k_h
kʼ	k_>
k͡xʼ	kx_>
l	l
m	m
mʰ	m_h
n	n
nʰ	n_h
pʰ	p_h
pʼ	p_>
r	r
s	s
tʰ	t_h
tʼ	t_>
t͡sʼ	ts_>
t͡ɬʼ	tK_>
t͡ʃʰ	tS_h
t͡ʃʼ	tS_>
u	u
v	v
w	w
x	x
z	z
ŋ	N
ǀ	|\
ǀʰ	|\h
ǁ	|\|\
ǁʰ	|\|\h
ǃ	!\
ǃʰ	!\h
ɓ	b_<
ɔ	O
ɛ	E
ɟ	J\
ɡ	g
ɡ͡ǀ	|\g_0
ɡ͡ǁ	|\|\g_0
ɡ͡ǃ	!\g_0
ɣ	G
ɬ	K
ɮ	K\
ɲ	J
ɲʰ	J_h
ʃ	S
