ə	@
əi	@i
a	a
ai	ai
ɛ	E
œ	9
əu	@u
œy	9y
ŋ	N
ɔ	O
ɔi	Oi
ʃ	S
ʒ	Z
æ	{
ɑː	A:
ɑːi	A:i
b	b
d	d
iə	i@
øː	2:
f	f
ɡ	g
ɦ	h\
i	i
iu	iu
j	j
k	k
l	l
m	m
n	n
uə	u@
uəi	u@i
p	p
r	r
s	s
t	t
tʃ	tS
dʒ	dZ
u	u
ui	ui
v	v
w	w
x	x
y	y
z	z
